{
  "tileMap": [
    [0, 1, 2, 3, 4, 5, 6, 7, 7, 5, 6, 7, 0, 1, 2, 3, 4, 5, 6, 0, 0, 0, 1, 0, 0, 1, 2, 3, 4, 5, 6, 7],
    [0, 1, 2, 3, 4, 5, 6, 7, 15, 0, 1, 2, 8, 9, 10, 11, 12, 13, 14, 8, 8, 8, 9, 8, 8, 0, 0, 1, 2, 3, 4, 5],
    [8, 9, 10, 11, 12, 13, 14, 15, 23, 8, 0, 1, 16, 17, 18, 19, 20, 21, 22, 16, 16, 16, 17, 16, 16, 8, 8, 9, 10, 11, 12, 13],
    [16, 17, 18, 19, 20, 21, 22, 23, 31, 16, 8, 9, 24, 25, 26, 27, 28, 29, 30, 24, 24, 24, 25, 24, 24, 16, 16, 17, 18, 19, 20, 21],
    [0, 1, 2, 3, 4, 5, 6, 7, 24, 24, 16, 17, 16, 16, 17, 16, 16, 16, 16, 16, 8, 8, 8, 8, 8, 24, 24, 25, 26, 27, 28, 29],
    [0, 1, 2, 3, 4, 5, 6, 7, 20, 21, 24, 25, 24, 24, 25, 24, 24, 0, 1, 2, 3, 4, 5, 6, 7, 0, 1, 2, 3, 4, 24, 25],
    [0, 1, 2, 3, 4, 5, 6, 7, 0, 1, 2, 3, 4, 5, 6, 7, 7, 7, 6, 7, 7, 7, 7, 7, 7, 8, 9, 10, 11, 12, 24, 25],
    [0, 1, 2, 3, 4, 5, 0, 0, 1, 2, 3, 4, 5, 6, 7, 15, 15, 15, 7, 7, 15, 15, 15, 15, 15, 0, 1, 2, 3, 4, 24, 25],
    [0, 1, 2, 3, 4, 5, 8, 0, 1, 2, 3, 4, 5, 6, 7, 0, 0, 0, 0, 1, 2, 3, 4, 5, 6, 7, 2, 3, 4, 5, 6, 24],
    [0, 1, 2, 3, 4, 5, 16, 0, 1, 2, 3, 4, 5, 6, 0, 8, 8, 8, 0, 0, 1, 2, 3, 4, 5, 6, 7, 3, 4, 5, 6, 24],
    [0, 0, 1, 2, 3, 4, 24, 8, 0, 1, 2, 3, 4, 0, 8, 16, 16, 16, 8, 0, 0, 1, 2, 3, 4, 5, 6, 7, 4, 5, 6, 24],
    [8, 0, 1, 2, 3, 4, 5, 16, 0, 1, 2, 3, 0, 8, 16, 24, 24, 24, 16, 8, 0, 1, 2, 3, 4, 5, 6, 7, 4, 5, 6, 24],
    [16, 0, 1, 2, 3, 4, 5, 24, 0, 1, 2, 0, 8, 16, 24, 24, 25, 26, 24, 16, 8, 0, 1, 2, 3, 4, 5, 6, 7, 5, 6, 24],
    [24, 0, 1, 2, 3, 4, 5, 6, 8, 0, 0, 8, 16, 24, 24, 25, 26, 27, 28, 24, 16, 0, 1, 2, 3, 4, 5, 6, 7, 5, 6, 24],
    [0, 1, 2, 3, 4, 5, 0, 1, 0, 1, 8, 16, 24, 24, 25, 26, 27, 28, 29, 30, 24, 0, 1, 2, 3, 4, 5, 6, 7, 6, 7, 24],
    [0, 1, 2, 3, 0, 1, 0, 0, 8, 9, 16, 24, 24, 25, 26, 27, 28, 29, 30, 31, 7, 0, 1, 2, 3, 4, 5, 6, 7, 6, 7, 24],
    [0, 1, 2, 3, 8, 9, 8, 8, 16, 17, 24, 24, 25, 26, 27, 28, 29, 30, 31, 23, 15, 0, 1, 2, 3, 4, 5, 6, 7, 6, 7, 24],
    [0, 1, 2, 3, 16, 17, 16, 16, 24, 25, 26, 27, 28, 29, 30, 31, 31, 31, 31, 31, 23, 0, 1, 2, 3, 4, 5, 6, 7, 14, 0, 24],
    [0, 1, 2, 3, 24, 25, 24, 24, 25, 26, 27, 28, 29, 30, 31, 27, 28, 29, 30, 31, 31, 0, 1, 2, 3, 4, 5, 6, 7, 6, 8, 24],
    [0, 1, 2, 3, 24, 25, 26, 27, 28, 29, 30, 31, 0, 24, 25, 26, 27, 28, 29, 30, 31, 0, 1, 2, 3, 4, 5, 6, 7, 6, 16, 24],
    [0, 1, 2, 3, 4, 5, 6, 0, 1, 2, 3, 4, 8, 24, 25, 26, 27, 28, 29, 30, 31, 0, 1, 2, 3, 4, 5, 6, 7, 14, 24, 25],
    [8, 9, 10, 11, 12, 13, 14, 0, 0, 0, 1, 0, 16, 24, 25, 26, 27, 28, 29, 30, 0, 1, 2, 3, 4, 5, 6, 7, 7, 6, 24, 25],
    [16, 17, 18, 19, 20, 21, 22, 8, 8, 8, 0, 8, 24, 24, 25, 26, 27, 28, 29, 0, 1, 2, 3, 4, 5, 6, 7, 15, 7, 6, 24, 25],
    [24, 25, 26, 27, 28, 29, 30, 0, 0, 1, 2, 3, 4, 5, 6, 7, 28, 29, 0, 1, 2, 3, 4, 5, 6, 7, 15, 23, 7, 6, 24, 25],
    [0, 1, 2, 3, 4, 5, 6, 8, 8, 9, 10, 11, 12, 13, 14, 15, 0, 1, 2, 3, 4, 5, 6, 7, 7, 15, 23, 31, 7, 6, 24, 25],
    [0, 1, 2, 3, 4, 5, 6, 16, 16, 17, 18, 19, 20, 21, 22, 23, 2, 3, 4, 5, 6, 7, 7, 15, 15, 23, 31, 31, 7, 5, 24, 25],
    [0, 1, 2, 3, 4, 5, 6, 24, 24, 25, 26, 27, 28, 29, 30, 31, 4, 5, 6, 7, 7, 15, 15, 23, 23, 31, 31, 23, 7, 5, 0, 24],
    [0, 1, 2, 3, 4, 5, 6, 24, 25, 26, 27, 28, 29, 30, 31, 5, 6, 7, 7, 15, 15, 23, 23, 31, 31, 30, 31, 31, 7, 0, 8, 24],
    [0, 1, 2, 3, 4, 5, 6, 24, 25, 26, 27, 28, 29, 30, 31, 7, 7, 15, 15, 23, 23, 31, 31, 29, 30, 31, 15, 6, 7, 8, 16, 24],
    [0, 0, 1, 2, 3, 4, 5, 24, 25, 26, 27, 28, 29, 30, 31, 15, 15, 23, 23, 31, 31, 27, 28, 29, 30, 31, 23, 6, 7, 16, 24, 25],
    [8, 8, 9, 10, 11, 12, 13, 24, 25, 26, 27, 28, 29, 30, 31, 23, 23, 31, 31, 25, 26, 27, 28, 29, 30, 31, 31, 14, 15, 24, 24, 25],
    [16, 16, 17, 18, 19, 20, 21, 24, 25, 26, 27, 28, 29, 30, 31, 31, 31, 8, 24, 25, 26, 27, 28, 29, 30, 31, 21, 22, 23, 25, 26, 27]
  ]
}